"filename", "language", "JavaScript", "CSS", "comment", "blank", "total"
"c:\Users\brock\source\repos\social\ui\src\App.js", "JavaScript", 90, 0, 7, 9, 106
"c:\Users\brock\source\repos\social\ui\src\Test.js", "JavaScript", 20, 0, 6, 7, 33
"c:\Users\brock\source\repos\social\ui\src\components\comments\AllComment.js", "JavaScript", 113, 0, 0, 3, 116
"c:\Users\brock\source\repos\social\ui\src\components\comments\CommentForm.js", "JavaScript", 39, 0, 0, 5, 44
"c:\Users\brock\source\repos\social\ui\src\components\comments\ListComments.js", "JavaScript", 80, 0, 0, 6, 86
"c:\Users\brock\source\repos\social\ui\src\components\comments\api.js", "JavaScript", 52, 0, 0, 4, 56
"c:\Users\brock\source\repos\social\ui\src\components\comments\comment.js", "JavaScript", 44, 0, 0, 7, 51
"c:\Users\brock\source\repos\social\ui\src\components\comments\commentListPage.js", "JavaScript", 85, 0, 19, 15, 119
"c:\Users\brock\source\repos\social\ui\src\components\comments\commentsHome.js", "JavaScript", 42, 0, 0, 5, 47
"c:\Users\brock\source\repos\social\ui\src\components\comments\createComment.js", "JavaScript", 65, 0, 8, 9, 82
"c:\Users\brock\source\repos\social\ui\src\components\comments\editComment.js", "JavaScript", 90, 0, 7, 17, 114
"c:\Users\brock\source\repos\social\ui\src\components\comments\index.css", "CSS", 0, 100, 0, 23, 123
"c:\Users\brock\source\repos\social\ui\src\components\feed\Feed.js", "JavaScript", 54, 0, 0, 5, 59
"c:\Users\brock\source\repos\social\ui\src\components\feed\feed.css", "CSS", 0, 0, 0, 1, 1
"c:\Users\brock\source\repos\social\ui\src\components\following\followButton.js", "JavaScript", 78, 0, 7, 42, 127
"c:\Users\brock\source\repos\social\ui\src\components\following\followCompsTestPage.js", "JavaScript", 29, 0, 5, 12, 46
"c:\Users\brock\source\repos\social\ui\src\components\following\followerListPage.js", "JavaScript", 75, 0, 5, 20, 100
"c:\Users\brock\source\repos\social\ui\src\components\following\followingListPage.js", "JavaScript", 64, 0, 18, 26, 108
"c:\Users\brock\source\repos\social\ui\src\components\following\followingSheet.css", "CSS", 0, 33, 0, 6, 39
"c:\Users\brock\source\repos\social\ui\src\components\following\getFollowerCount.js", "JavaScript", 34, 0, 5, 20, 59
"c:\Users\brock\source\repos\social\ui\src\components\following\getFollowingCount.js", "JavaScript", 34, 0, 5, 17, 56
"c:\Users\brock\source\repos\social\ui\src\components\home.js", "JavaScript", 54, 0, 7, 15, 76
"c:\Users\brock\source\repos\social\ui\src\components\homepage\HomePage.js", "JavaScript", 44, 0, 0, 4, 48
"c:\Users\brock\source\repos\social\ui\src\components\homepage\homepage.css", "CSS", 0, 16, 0, 2, 18
"c:\Users\brock\source\repos\social\ui\src\components\navbar.js", "JavaScript", 25, 0, 5, 6, 36
"c:\Users\brock\source\repos\social\ui\src\components\postLikedByPage\api\api.js", "JavaScript", 7, 0, 0, 2, 9
"c:\Users\brock\source\repos\social\ui\src\components\postLikedByPage\postLikedByPage.js", "JavaScript", 28, 0, 0, 6, 34
"c:\Users\brock\source\repos\social\ui\src\components\post\createPost.js", "JavaScript", 71, 0, 0, 7, 78
"c:\Users\brock\source\repos\social\ui\src\components\post\defaultLayout.js", "JavaScript", 23, 0, 0, 8, 31
"c:\Users\brock\source\repos\social\ui\src\components\post\feedPage.js", "JavaScript", 74, 0, 14, 5, 93
"c:\Users\brock\source\repos\social\ui\src\components\post\getAllPost.js", "JavaScript", 47, 0, 0, 8, 55
"c:\Users\brock\source\repos\social\ui\src\components\post\post.js", "JavaScript", 35, 0, 0, 3, 38
"c:\Users\brock\source\repos\social\ui\src\components\post\publicFeedPage.js", "JavaScript", 44, 0, 14, 4, 62
"c:\Users\brock\source\repos\social\ui\src\components\post\updatePost.js", "JavaScript", 67, 0, 0, 28, 95
"c:\Users\brock\source\repos\social\ui\src\components\privateUserLikeList\PrivateUserLikeListPage.js", "JavaScript", 29, 0, 8, 4, 41
"c:\Users\brock\source\repos\social\ui\src\components\privateUserLikeList\api\api.js", "JavaScript", 7, 0, 0, 2, 9
"c:\Users\brock\source\repos\social\ui\src\components\project-notes\contributor.js", "JavaScript", 25, 0, 7, 4, 36
"c:\Users\brock\source\repos\social\ui\src\components\project-notes\contributorListPage.js", "JavaScript", 55, 0, 19, 13, 87
"c:\Users\brock\source\repos\social\ui\src\components\project-notes\contributorNavbar.js", "JavaScript", 18, 0, 1, 2, 21
"c:\Users\brock\source\repos\social\ui\src\components\project-notes\createContributor.js", "JavaScript", 74, 0, 8, 12, 94
"c:\Users\brock\source\repos\social\ui\src\components\project-notes\editContributor.js", "JavaScript", 94, 0, 7, 19, 120
"c:\Users\brock\source\repos\social\ui\src\components\register\Register.js", "JavaScript", 157, 0, 2, 8, 167
"c:\Users\brock\source\repos\social\ui\src\components\register\register.css", "CSS", 0, 4, 0, 0, 4
"c:\Users\brock\source\repos\social\ui\src\components\users\Landingpage.js", "JavaScript", 21, 0, 3, 3, 27
"c:\Users\brock\source\repos\social\ui\src\components\users\Login.js", "JavaScript", 140, 0, 1, 12, 153
"c:\Users\brock\source\repos\social\ui\src\components\users\PrivateUserProfile.js", "JavaScript", 194, 0, 7, 16, 217
"c:\Users\brock\source\repos\social\ui\src\components\users\PublicProfilePage.js", "JavaScript", 37, 0, 11, 15, 63
"c:\Users\brock\source\repos\social\ui\src\components\users\PublicUser.js", "JavaScript", 67, 0, 0, 16, 83
"c:\Users\brock\source\repos\social\ui\src\components\users\editUserPage.js", "JavaScript", 128, 0, 9, 15, 152
"c:\Users\brock\source\repos\social\ui\src\index.js", "JavaScript", 18, 0, 3, 3, 24
"c:\Users\brock\source\repos\social\ui\src\utilities\decodeJwt.js", "JavaScript", 7, 0, 0, 2, 9
"Total", "-", 2678, 153, 218, 503, 3552